--||---//--
-    -    |
-    *    -
l    -    -
t    -    P
p    -    -
------M----

Salad
Burger

2 1
7 1
7 4
2 4
