--||---//--
-    -    -
-    *    -
l    -    -
t    -    P
p    -    o
------M----

Burger
Salad

2 1
7 1

0 5
5 10
