--|pl--//--
-    -    |
-    *    -
-    -    -
t    -    P
-    -    -
------M----

SimpleLettuce

2 1
7 1

0 5
5 10
