--//---//--
|    -    |
-    *    -
l    -    -
-    t    p
P    -    -
-p----M--p-

Burger

2 1
7 1
7 4
2 4
